1,S,1,1,1,1,1,1,1,1,1,1,1,1,1,1,1,1,1,1,1,1,1,1,1,1,1,1,1,1,1,1
1,0,0,0,0,1,C,C,C,0,T,1,D,D,1,C,0,C,1,C,0,C,C,1,D,D,1,D,D,D,1,1
1,0,1,1,1,1,0,1,1,1,1,1,0,0,0,0,1,C,0,C,1,1,0,0,D,D,0,D,D,D,0,1
1,0,1,0,D,0,D,1,D,C,T,1,D,1,1,1,1,1,1,1,1,1,1,1,1,1,1,1,1,1,0,1
1,0,1,1,0,1,D,D,D,C,T,1,0,1,D,0,C,0,0,C,0,0,D,D,0,0,D,1,0,C,0,1
1,C,C,1,D,1,D,1,1,1,1,1,0,1,D,1,1,1,1,1,1,1,1,1,1,1,0,1,0,1,1,1
1,1,C,M,0,D,0,0,0,D,0,0,0,1,C,1,0,0,C,0,0,0,0,0,C,1,D,1,0,C,T,1
1,T,1,1,1,D,1,D,1,0,1,1,1,1,C,1,C,1,1,1,1,1,1,1,0,1,0,1,0,1,1,1
1,C,1,0,0,0,1,0,1,C,0,0,D,1,D,1,0,1,D,D,D,M,0,1,0,1,0,1,0,C,T,1
1,C,1,0,1,0,1,0,1,0,1,1,0,1,D,1,0,1,D,D,D,1,0,1,C,1,0,1,0,1,1,1
1,C,1,D,1,T,1,C,0,D,0,1,C,1,C,1,C,1,D,D,D,1,0,1,0,1,D,1,0,C,0,1
1,C,1,0,1,1,1,0,1,0,1,1,0,1,C,1,0,0,D,D,D,1,E,1,0,1,D,1,1,1,0,1
1,0,0,0,0,T,1,0,1,1,1,1,D,1,D,1,1,1,1,1,1,1,1,1,D,1,0,1,0,1,0,1
1,0,1,1,1,1,1,D,0,D,0,0,0,1,D,D,0,0,0,0,0,D,0,D,M,D,0,D,0,C,0,1
1,C,0,C,0,D,0,D,1,1,1,1,D,1,D,1,1,1,0,1,1,1,1,1,1,1,1,1,1,1,1,1
1,1,1,M,1,1,1,0,1,0,0,1,0,1,0,1,T,1,T,1,D,0,D,0,0,D,0,D,0,0,D,1
1,0,D,0,1,T,1,C,1,C,C,1,D,1,C,1,T,1,1,1,0,1,1,1,1,1,1,1,1,1,0,1
1,0,1,1,1,T,1,0,1,D,C,1,0,1,D,1,C,0,C,0,0,0,D,0,0,D,1,D,0,0,0,1
1,C,0,1,0,0,0,D,1,D,1,1,C,1,0,1,1,1,1,1,1,1,1,1,1,0,1,0,1,1,0,1
1,1,D,T,1,1,1,0,1,D,0,0,D,1,0,D,0,0,0,D,0,0,0,D,0,0,1,0,0,1,D,1
1,1,0,C,D,T,1,C,1,1,1,1,1,1,1,1,1,1,1,1,1,1,1,1,1,1,1,1,0,1,0,1
1,T,D,1,C,1,1,0,1,0,0,0,1,D,C,D,C,D,0,0,D,C,D,C,D,C,D,C,D,1,0,1
1,T,C,1,T,T,1,0,0,0,1,0,0,D,C,D,C,D,0,D,C,D,C,D,C,D,C,D,C,0,0,1
1,1,1,1,1,1,1,1,1,1,1,1,1,1,1,1,1,1,1,1,1,1,1,1,1,1,1,1,1,1,1,1