1,S,1,1,1,1,1,1,1,1,1,1,1,1,1,1
1,0,0,1,1,0,D,0,0,T,O,0,0,C,0,1
1,0,O,0,0,0,1,1,0,0,0,1,1,1,0,1
1,1,1,1,1,1,1,1,1,1,1,1,1,0,0,1
1,C,T,1,T,0,0,1,0,0,M,O,1,0,1,1
1,C,C,1,0,1,O,1,0,1,1,0,0,O,0,1
1,0,1,1,0,1,0,1,O,1,1,1,1,0,1,1
1,0,0,0,0,1,O,0,0,1,T,0,0,0,1,1
1,T,T,1,1,1,1,1,1,1,1,1,1,O,C,1
1,1,1,1,0,M,O,1,1,O,D,0,1,0,C,1
1,0,0,0,0,1,O,0,0,O,1,0,0,O,1,1
1,E,1,1,1,1,1,1,1,1,1,1,1,1,1,1