1,S,1,1,1,1,1,1,1,1,1,1,1,1,1,1
1,0,0,1,1,0,0,M,0,T,0,0,M,C,0,1
1,0,0,M,0,0,1,1,0,0,0,1,1,1,0,1
1,1,1,1,1,1,1,1,1,1,1,1,1,0,0,1
1,C,T,1,T,0,0,1,0,0,0,0,1,0,1,1
1,C,C,1,0,1,0,1,0,1,1,0,0,0,0,1
1,0,1,1,0,1,0,1,0,1,1,1,1,0,1,1
1,0,0,0,0,1,0,0,0,1,T,0,0,0,1,1
1,T,T,1,1,1,1,1,1,1,1,1,1,0,C,1
1,1,1,1,0,0,0,1,1,0,0,0,1,0,C,1
1,0,0,0,0,1,0,0,0,0,1,0,0,0,1,1
1,E,1,1,1,1,1,1,1,1,1,1,1,1,1,1